30 30
S#############################
 #############################
 ######           ############
 ###### ######### ############
 ###### #     ### ############
 ###### # ### ###       ######
 ###### # #      ###### ######
 ####   # # #######     ######
 #### ### # ####### ##########
 #### ##  #   ##### #      ###
 #### ## #### ##### ## ###   #
 #### ## #      ###    ##### #
 ####    # #### ########     #
 #########   ## ####     # ###
 ###########      ## ##### ###
 ########### ####  # ##### ###
 ########### #### ## #        
 ########### #      ## ###### 
 ########### #########      # 
 ########### ################ 
 ###########     ########     
 ############## ######### ### 
 ########G      #########   # 
 ############################ 
 #######################      
 ####################### #### 
 ####################### #### 
 #######################      
 ############################ 
                              
